WWWWWWWWWWWWWWWWWWWWWWWWW
WE2EBEEBEBBEEBEEEBEBBEEEW
WEWBWEWBWEWBWEWEWEWEWEWEW
WEEEEBEBEEBBEEEBEEEEEEEMW
WEWBWEWBWEWEWGWEWEWEWBWEW
WEEEBESEEBEBEEEBEBEBEBEEW
WEWEWEWBWEWEWEWEWBWEWEWEW
WEEEEEEMEEEEEEIEEEBBEEEEW
WEWBWBWEWBWEWEWEWEWEWBWEW
WBEBEEEEEEBEBEEEEEEEEEEEW
WEWEWEWEWEWEWEWBWEWBWBWBW
WEEEBEEEBGEBEBEBEEBEEE1EW
WWWWWWWWWWWWWWWWWWWWWWWWW