WWWWWWWWWWWWWWWWWWWWWWWWWWWWWWWWWWWWWW
WE2EEEEBEEEEEEWWEWEWEWEEEEEEWEWBEEEEEW
WEWBWEWEWEWBEEEEEEEEBEWEWEBEEEEEEBEEEW
WEEEEEEBEEEEEEEWEBEWEEBEWEEWEBEWEEEEEW
WEWEEEEEWEWEEEEEBBEWEEWEEEEEEEEEEEBWEW
WEEBEEEEEEEEEEEEEEBWEEWBWEEEEWEEEWEWEW
WEWEWEWEWBWEWEEEEBWEEWWWEEEBWEEEWWBWEW
WEWEWEEEEEEEEEEEEBEEEEEEEEEWBEWEEWBEEW
WEEBEEEEEEEEEEEBEEEEEEEEEEEEEWEEWBWEEW
WEWEEEEEEEWEWEEEBEEWEWEBEWEEEEEEEEEEEW
WEEBMEEEEEEWEEEBEEEEEEEEEEWEEWEEBWBEEW
WEWEWEWEWBWEWEEWEWEWEEBEEEEEWEEEWEEBEW
WEEEEEBEEEEEEEEEWEWEEEWWEBWEEEEEEWEBEW
WEWEWEWEWEWEWEBWEEEEEEEEEEEEWEEEEEEEEW
WEEBEEEEEEMEEEEEWEEWEEEEEEEWEEBEWWBWEW
WEWEWEWEWBWEWEEBEEWBBEWBEEWEEEEEEEBEEW
WEEBEEEEEEEEEEEEBEWEEEEEEEWEWEEBE1EEEW
WWWWWWWWWWWWWWWWWWWWWWWWWWWWWWWWWWWWWW