WWWWWWWWWWWWWWWWWWWWWWWWW
WE2EBEEBEBBEEBEEEBEBBEEEW
WEWBWEWBWEWBWEWEWEWEWEWEW
WEEEEBEBEEBBEEEBEEEEEEEMW
WEWBWEWBWEWEWGWEWEWEWBWEW
WEEEEESEEBEBEEEBEBEBEBEEW
WEWEWEWBWEWEWEWEWBWEWEWEW
WEEEEEEMEEEEEEEBEEBBEEEEW
WEWBWBWEWBWEWEWEWEWEWBWEW
WBEBEEEEEEBEEEEBEEEEEEEEW
WEWEWEWEWEWEWEWBWEWBWBWBW
WEEEBEEEBGEBEBEBEEBEEE1EW
WWWWWWWWWWWWWWWWWWWWWWWWW