WWWWWWWWWWWWWWW
WE2EEEEEEEEEEEW
WEWBWEWEWEWBWEW
WEEEEEEEEEEEEEW
WEWEWEWEWEWEWWW
WEEBEEEEEEEEEEW
WEWEWEWEWBWEWEW
WEEEMEEEEEEEEEW
WEWEWEWEWEWEWEW
WEEEEEBEEEEEEEW
WEWEWEWEWEWEWEW
WEEEEEEEEEMEEEW
WEWEWEWEWBWEWEW
WEEBEEEEEEEE1EW
WWWWWWWWWWWWWWW