WWWWWWWWWWWWWWW
WE1EEEEEEEEEEEW
WEWBWEWEWEWBWEW
WEEEEEEEEEEEEEW
WEWEWEWEWEWEWWW
WEEBEEEEEEEEEEW
WEWEWEWEWBWEWEW
WEEEMEEEEEEEEEW
WEWEWEWEWEWEWEW
WEEEEEBEEEEEEEW
WEWEWEWEWEWEWEW
WEEEEEEEEEMEEEW
WEWEWEWEWBWEWEW
WEEBEEEEEEEE2EW
WWWWWWWWWWWWWWW