WWWWWWWWWWWWWWWWWWWWWWWWW
WE2EBEEBEBBEEBEEEBEBBEEEW
WEWBWEWBWEWBWEWEWEWEWEWEW
WEEEEBEBEEBBEEEBEEEEEEEMW
WEWBWEWBWEWEWGWEWEWEWBWEW
WEEEEEEEEBEBEEEBEBEBEBEEW
WBWEWEWBWEWEWEWEWBWEWEWEW
WEEEEEEMEEEEEEEBEEBBEEEEW
WEWBWBWEWBWEWEWEWEWEWBWEW
WBEBEEEEEEBEEEEBEEEEEEEEW
WEWEWEWEWEWEWEWBWEWBWBWBW
WEEEBEEEBGEBEBEBEEBEEE1EW
WWWWWWWWWWWWWWWWWWWWWWWWW