WWWWWWWWWWWWWWWWWWWWWWWWWWWWWWWWWWWWWW
WE2EEEEWEEBEEEWWEWEBEWEEEEEEBEWBEEEEEW
WEWBWEWEWEWBEEEWWEEWEEWEBEBEBEEWEBEEEW
WBEEEEEBEEEWEEEEEBEEEEBEWEEEEBEWEEEBEW
WEEEWEEEWEBEWEEEEEEEEEWEEEEEEMEEEEBEEW
WEEBEEEWEEEEEEEEEEEEEEEEEEEEEEEEEEEEEW
WEEEWEEEEEBEWEEMEEWEEWEEEEEBWEEEWEBWEW
WEWEEEBEEEEEEEEEEBEEEEBEEEEWEEEEEWBEEW
WEEEEEEWEEEEEEEBEEEEEWEWWEEEEWEEWEEEEW
WEWEWEWEEEEEWEEEBEEEEEEBEWEEWEWEEEEEEW
WEEBMEEEEEEWEEEBEEEEEEEEEEWEEWEEBWBEEW
WEWEEEWEWEEEEEEWEEEWEEBEEEEEEEEEEEEBEW
WEEEEEBEEEEEEEEEWEWEEEWWEBWEEEEEEWEBEW
WEWEWEEEEEEEWEEWEEEBEEMEEEEEEEEEBEEEEW
WEEBEEWEEEEEEEBEWEEWEEEBEEEWEEBEWWBWEW
WEWEWEWMWBWEWEEBEEWBBEWBEEWEEEEEEEBEEW
WEEBEEWEBEEEEWEEBEWEEEEEEEWEWEEBE1EEEW
WWWWWWWWWWWWWWWWWWWWWWWWWWWWWWWWWWWWWW