WWWWWWWWWWWWWWWWWWWWWWWWWWWWWWWWWWWWWW
WE2EEEEWEEBEEEWWEWEBEWEEEEEEBEWBEEEEEW
WEWBWEWEWEWBEEEWWEEWEEWEBEBEBEEWEBEEEW
WBEEEEEBEEEWEEEEEBEEEEBEWEEEEBEWEEEBEW
WEEEWEEEWEBEWEEEEEEEEEWEEEEEEEEEEEBEEW
WEEBEEEWEEEEEEEEEEEEEEEEEEEEEEEEEEEEEW
WEEEWEEEEEBEWEEEEEWEEWEEEEEBWEEEWEBWEW
WEWEEEBEEEEEEEEEEBEEEEBEEEEWEEEEEWBEEW
WEEEEEEWEEEEEEEBEEEEEWEWWEEEEWEEWEEEEW
WEWEWEWEEEEEWEEEBEEEEEEBEWEEWEWEEEEEEW
WEEBMEEEEEEWEEEBEEEEEEEEEEWEEWEEBWBEEW
WEWEEEWEWEEEEEEWEEEWEEBEEEEEEEEEEEEBEW
WEEEEEBEEEEEEEEEWEWEEEWWEBWEEEEEEWEBEW
WEWEWEEEEEEEWEEWEEEBEEEEEEEEEEEEBEEEEW
WEEBEEWEEEEEEEBEWEEWEEEBEEEWEEBEWWBWEW
WEWEWEWEWBWEWEEBEEWBBEWBEEWEEEEEEEBEEW
WEEBEEWEBEEEEWEEBEWEEEEEEEWEWEEBE1EEEW
WWWWWWWWWWWWWWWWWWWWWWWWWWWWWWWWWWWWWW