WWWWWWWWWWWWWWWWWWWWWWWWW
WE2EBEEBEBBEEBEEEBEBBEEEW
WEWBWEWBWEWBWEWEWEWEWEWEW
WEEEEBEBEEBBEEEBEEEEEEEGW
WEWBWEWBWEWEWMWEWEWEWBWEW
WEEEEEEEEBEBEEEBEBEBEBEEW
WBWEWEWBWEWEWEWEWBWEWEWEW
WEEEEEEGEEEEEEEBEEBBEEEEW
WEWBWBWEWBWEWEWEWEWEWBWEW
WBEBEEEEEEBEEEEBEEEEEEEEW
WEWEWEWEWEWEWEWBWEWBWBWBW
WEEEBEEEBMEBEBEBEEBEEE1EW
WWWWWWWWWWWWWWWWWWWWWWWWW