WWWWWWWWWWWWWWWWWWWWWWWWWWWWWWWWWWWWWW
WEBE2EEEWEEEEEBEWEEEWEBEEEEEEWEEEEEEEW
WEWEEEEEBEEEBEEEBEEWEEBEEEEEEBEEEWEEEW
WEEEEEWEEEEEWEEWEEEEEWEEEEEWEEWEEEEEWW
WEBEBWEEEEEEBEEEBEEEWEBWBEEEEEBEEEEEEW
WEEEBEWWEEEEEBWEEWEEEWEBEEEEEBEWEEEBEW
WEEEEEEEEWEEEWEWEEEEWEEEEEEWEEEWEEEBEW
WEEEWEEWEEEEEEWEEWEEEEEEWEEEEEEEEEWEEW
WEWEEEEWEEEBEEEEEBEEEWEEWEEWEEEEEEEEBW
WEEEEEEEWEEEEWEEEBEEEBWEEEEWEEEEWEEEEW
WEWEEEEEEEEEEEBWEEEEWEEEEEEWEEEWEEBWEW
WEBEEEEEWEEEEEBWEEEEEEEBEEEWEEEWEEEEEW
WEEWEEWEEEEEEWEEEEEWEEEEEWEBEEEEEEBEEW
WEEWEEEEEWEEWEEWEEWEEEEEEEBEWEEEEEWEEW
WEBEEEEEEEWEEWEEWEEEEEEWEEEEEEWEEEEBEW
WEEEBEEEWEBEEEEEBEEEWWEEEEEEEWEEEEEEEW
WEEEEEEWEEEEEEEBWEEEBEEEEEEEBEEE1EEWEW
WWWWWWWWWWWWWWWWWWWWWWWWWWWWWWWWWWWWWW
