WWWWWWWWWWWWWWWWWWWWWWWWW
WE2EBEEBEBBEEBEEEBEBBEEEW
WEWBWEWBWEWBWEWEWEWEWEWEW
WEEEEBEBEEBBEEEBEEEEEEEEW
WEWBWEWBWEWEWEWEWEWEWBWEW
WEEEEEEESBEBEEEBEBEBEBEEW
WBWEWEWBWEWEWEWEWBWEWEWEW
WEEEEEEGEEEEEIEBEEBBEEEEW
WEWBWBWEWBWEWEWEWEWEWBWEW
WBEBEEEEEEBEEEEBEEEEEEEEW
WEWEWEWEWEWEWEWBWEWBWBWBW
WEEEBEEEBMEBEBEBEEBEEE1EW
WWWWWWWWWWWWWWWWWWWWWWWWW