WWWWWWWWWWWWWWWWWWWWWWWWWWWWWWWWWWWWWW
WEBE2EEEWEEEEEBEWEEEWEBEEEEEEWEEEEEEEW
WEWEEEEEBEEEBEEEBEEWEEBEEEEEEBEEEWEEEW
WEEEEEWEEEEEWEEWEEEEEWEEEEEWEEWEEEEEWW
WEBEBWEMEEEEBEEEBEEEWEBWBEEEEEBEEEEEEW
WEEEBEWWEEEEEBWEMWEEEWEBEEEEEBEWEEEBEW
WEEEEEEEEWEEEWEWEEEEWEEEEEEWEEEWEEEBEW
WEEEWEEWEEEEEEWEEWEEEEEEWEEEEEEEEEWEEW
WEWEEEEWEEEBEEEEEBEEEWEEWEEWEEEEEEEEBW
WEEEEEEEWEEEEWEEEBEEEBWEEEEWEEEEWEEEEW
WEWEEEEEEEEEEEBWEEEEWEEEEEEWEEEWEEBWEW
WEBEEEEEWEEEEEBWEEEEEEEBEEEWEEEWEEEEEW
WEEWEEWEEEEEEWEEEEEWEEEEEWEBEMEEEEBEEW
WEEWEEEEEWEEWEEWEEWEEEEEEEBEWEEEEEWEEW
WEBEEEMEEEWEEWEEWEEEEEEWEEEEEEWEEEEBEW
WEEEBEEEWEBEEEEEBEEEWWEEEEEEEWEEEEEEEW
WEEEEEEWEEEEEEEBWEEEBEEMEEEEBEEE1EEWEW
WWWWWWWWWWWWWWWWWWWWWWWWWWWWWWWWWWWWWW
