WWWWWWWWWWWWWWWWWWWWWWWWW
WE2EBEEBEBBEEBEEEBEBBEEEW
WEWBWEWBWEWBWEWEWEWEWEWEW
WEEEEBEBEEBBEEEBEEEEEEEMW
WEWBWEWBWEWEWMWEWEWEWBWEW
WEEEEEEEEBEBEEEBEBEBEBEEW
WBWEWEWBWEWEWEWEWBWEWEWEW
WEEEEEEMEEEEEEEBEEBBEEEEW
WEWBWBWEWBWEWEWEWEWEWBWEW
WBEBEEEEEEBEEEEBEEEEEEEEW
WEWEWEWEWEWEWEWBWEWBWBWBW
WEEEBEEEBMEBEBEBEEBEEE1EW
WWWWWWWWWWWWWWWWWWWWWWWWW